Corporate Entity Type,Chain,Brand,SKU,Region,Year,Month,Price,Volume,Revenue,Margin,Base Volume,Incremental Volume,Base Revenue,Incremental Revenue,Base Margin,Incremental Margin,Promo1 Expense,Promo2 Expense,Promo3 Expense
Hyper Market,Chain1,Confectionery,Delight Bar(40g),North,2018,1,1.29,47644,61461,31445,41068,6576,52978,8483,22962,8483,385,675,555
Hyper Market,Chain1,Confectionery,Delight Bar(40g),North,2018,2,1.06,51747,54852,22251,41457,10290,43944,10908,11343,10908,941,520,264
Hyper Market,Chain1,Confectionery,Delight Bar(40g),North,2018,3,1.85,33985,62872,41462,26888,7097,49743,13129,28332,13130,341,381,827
Hyper Market,Chain1,Confectionery,Delight Bar(40g),North,2018,4,1.23,46747,57499,28048,33425,13322,41113,16386,11662,16386,422,387,937
Hyper Market,Chain1,Confectionery,Delight Bar(40g),North,2018,5,1.16,52296,60663,27717,42473,9823,49269,11394,16323,11394,220,426,831
Hyper Market,Chain1,Confectionery,Delight Bar(40g),North,2018,6,1.77,37320,66056,42545,28480,8840,50410,15646,26898,15647,631,784,630
Hyper Market,Chain1,Confectionery,Delight Bar(40g),North,2018,7,1.54,36393,56045,33118,26843,9550,41338,14707,18410,14708,135,546,398
Hyper Market,Chain1,Confectionery,Delight Bar(40g),North,2018,8,1.41,39135,55180,30525,30092,9043,42430,12750,17775,12750,849,952,403
Hyper Market,Chain1,Confectionery,Delight Bar(40g),North,2018,9,1.68,36076,60608,37880,28867,7209,48497,12111,25769,12111,737,321,434
Hyper Market,Chain1,Confectionery,Delight Bar(40g),North,2018,10,1.48,37598,55645,31958,32413,5185,47971,7674,24284,7674,279,403,866
Hyper Market,Chain1,Confectionery,Delight Bar(40g),North,2018,11,1.14,46054,52502,23488,32944,13110,37556,14946,8542,14946,685,422,119
Hyper Market,Chain1,Confectionery,Delight Bar(40g),North,2018,12,1.86,39179,72873,48190,32155,7024,59808,13065,35125,13065,876,796,514
Hyper Market,Chain1,Confectionery,Delight Bar(40g),North,2019,1,1.48,44428,65753,37764,38328,6100,56725,9028,28735,9029,537,653,741
Hyper Market,Chain1,Confectionery,Delight Bar(40g),North,2019,2,1,53078,53078,19639,37238,15840,37238,15840,3799,15840,229,679,444
Hyper Market,Chain1,Confectionery,Delight Bar(40g),North,2019,3,1.62,37932,61450,37553,33119,4813,53653,7797,29756,7797,197,656,981
Hyper Market,Chain1,Confectionery,Delight Bar(40g),North,2019,4,1.73,33982,58789,37380,28764,5218,49762,9027,28353,9027,869,952,320
Hyper Market,Chain1,Confectionery,Delight Bar(40g),North,2019,5,1.31,50165,65716,34112,35375,14790,46341,19375,14737,19375,955,610,467
Hyper Market,Chain1,Confectionery,Delight Bar(40g),North,2019,6,1,55571,55571,20561,42498,13073,42498,13073,7488,13073,665,826,152
Hyper Market,Chain1,Confectionery,Delight Bar(40g),North,2019,7,1.74,37554,65344,41685,32404,5150,56383,8961,32724,8961,564,353,771
Hyper Market,Chain1,Confectionery,Delight Bar(40g),North,2019,8,1.19,45037,53594,25221,39898,5139,47479,6115,19106,6115,128,794,432
Hyper Market,Chain1,Confectionery,Delight Bar(40g),North,2019,9,1.85,33070,61180,40345,23858,9212,44137,17043,23303,17042,818,386,456
Hyper Market,Chain1,Confectionery,Delight Bar(40g),North,2019,10,1.26,49955,62943,31472,41494,8461,52282,10661,20810,10662,613,430,912
Hyper Market,Chain1,Confectionery,Trio Bar(100g),North,2018,1,2.48,40719,100983,51713,31197,9522,77369,23614,28099,23614,442,633,819
Hyper Market,Chain1,Confectionery,Trio Bar(100g),North,2018,2,2.03,44246,89819,36282,32666,11580,66312,23507,12774,23508,825,957,437
Hyper Market,Chain1,Confectionery,Trio Bar(100g),North,2018,3,3.45,33570,115817,75197,29595,3975,102103,13714,61483,13714,935,196,685
Hyper Market,Chain1,Confectionery,Trio Bar(100g),North,2018,4,2.38,38675,92047,45250,30368,8307,72276,19771,25479,19771,537,973,882
Hyper Market,Chain1,Confectionery,Trio Bar(100g),North,2018,5,2.27,40479,91887,42908,33840,6639,76817,15070,27837,15071,684,810,716
Hyper Market,Chain1,Confectionery,Trio Bar(100g),North,2018,6,3.33,32773,109134,69479,26622,6151,88651,20483,48996,20483,350,542,877
Hyper Market,Chain1,Confectionery,Trio Bar(100g),North,2018,7,2.9,31945,92641,53987,24189,7756,70148,22493,31495,22492,294,775,895
Hyper Market,Chain1,Confectionery,Trio Bar(100g),North,2018,8,2.67,34300,91581,50078,28166,6134,75203,16378,33700,16378,317,563,367
Hyper Market,Chain1,Confectionery,Trio Bar(100g),North,2018,9,3.16,31712,100210,61838,27660,4052,87406,12804,49034,12804,739,984,761
Hyper Market,Chain1,Confectionery,Trio Bar(100g),North,2018,10,2.81,32815,92210,52504,28683,4132,80599,11611,40893,11611,946,943,656
Hyper Market,Chain1,Confectionery,Trio Bar(100g),North,2018,11,2.2,39023,85851,38633,33254,5769,73159,12692,25941,12692,586,499,573
Hyper Market,Chain1,Confectionery,Trio Bar(100g),North,2018,12,3.48,36866,128294,83686,26547,10319,92384,35910,47776,35910,990,723,233
Hyper Market,Chain1,Confectionery,Trio Bar(100g),North,2019,1,2.78,40047,111331,62874,30044,10003,83522,27809,35065,27809,157,121,873
Hyper Market,Chain1,Confectionery,Trio Bar(100g),North,2019,2,1.95,41969,81840,31057,30932,11037,60317,21523,9535,21522,272,293,979
Hyper Market,Chain1,Confectionery,Trio Bar(100g),North,2019,3,3.1,32483,100697,61393,23004,9479,71312,29385,32008,29385,121,908,724
Hyper Market,Chain1,Confectionery,Trio Bar(100g),North,2019,4,3.25,30117,97880,61439,24425,5692,79381,18499,42939,18500,240,473,649
Hyper Market,Chain1,Confectionery,Trio Bar(100g),North,2019,5,2.46,46177,113595,57721,33273,12904,81852,31743,25978,31743,893,716,425
Hyper Market,Chain1,Confectionery,Trio Bar(100g),North,2019,6,1.91,47821,91338,33475,40032,7789,76461,14877,18598,14877,777,789,380
Hyper Market,Chain1,Confectionery,Trio Bar(100g),North,2019,7,3.24,37417,121231,75957,28205,9212,91384,29847,46109,29848,979,464,415
Hyper Market,Chain1,Confectionery,Trio Bar(100g),North,2019,8,2.27,38870,88235,41202,34921,3949,79271,8964,32238,8964,831,173,246
Hyper Market,Chain1,Confectionery,Trio Bar(100g),North,2019,9,3.45,31569,108913,70715,25230,6339,87044,21869,48846,21869,267,111,335
Hyper Market,Chain1,Confectionery,Trio Bar(100g),North,2019,10,2.43,42681,103715,52071,31487,11194,76513,27202,24869,27202,618,270,962
Hyper Market,Chain1,Confectionery,Tin Box Fudge(450g),North,2018,1,3.58,18971,67916,34148,14520,4451,51982,15934,18214,15934,536,943,464
Hyper Market,Chain1,Confectionery,Tin Box Fudge(450g),North,2018,2,2.97,17764,52759,21139,13401,4363,39801,12958,8181,12958,338,248,732
Hyper Market,Chain1,Confectionery,Tin Box Fudge(450g),North,2018,3,5.08,11975,60833,39518,10378,1597,52720,8113,31405,8113,867,270,183
Hyper Market,Chain1,Confectionery,Tin Box Fudge(450g),North,2018,4,3.45,17586,60672,29369,12437,5149,42908,17764,11605,17764,405,219,489
Hyper Market,Chain1,Confectionery,Tin Box Fudge(450g),North,2018,5,3.19,20376,64999,28730,14444,5932,46076,18923,9807,18923,215,869,951
Hyper Market,Chain1,Confectionery,Tin Box Fudge(450g),North,2018,6,4.8,15282,73354,46152,13265,2017,63672,9682,36470,9682,308,167,834
Hyper Market,Chain1,Confectionery,Tin Box Fudge(450g),North,2018,7,4.26,12510,53293,31025,9939,2571,42340,10953,20072,10953,247,770,664
Hyper Market,Chain1,Confectionery,Tin Box Fudge(450g),North,2018,8,3.93,13101,51487,28167,10656,2445,41878,9609,18558,9609,213,667,356
Hyper Market,Chain1,Confectionery,Tin Box Fudge(450g),North,2018,9,4.6,14317,65858,40374,11903,2414,54754,11104,29270,11104,823,404,403
Hyper Market,Chain1,Confectionery,Tin Box Fudge(450g),North,2018,10,4.03,15548,62658,34983,13153,2395,53007,9651,25332,9651,478,804,816
Hyper Market,Chain1,Confectionery,Tin Box Fudge(450g),North,2018,11,3.16,18371,58052,25352,15051,3320,47561,10491,14861,10491,218,521,571
Hyper Market,Chain1,Confectionery,Tin Box Fudge(450g),North,2018,12,5.07,15270,77419,50238,13416,1854,68019,9400,40838,9400,438,655,486
Hyper Market,Chain1,Confectionery,Tin Box Fudge(450g),North,2019,1,4.05,16813,68093,38166,12963,3850,52500,15593,22573,15593,192,203,453
Hyper Market,Chain1,Confectionery,Tin Box Fudge(450g),North,2019,2,2.76,20366,56210,19959,15432,4934,42592,13618,6341,13618,892,240,550
Hyper Market,Chain1,Confectionery,Tin Box Fudge(450g),North,2019,3,4.42,15754,69633,41591,13871,1883,61310,8323,33268,8323,372,878,406
Hyper Market,Chain1,Confectionery,Tin Box Fudge(450g),North,2019,4,4.77,11885,56691,35536,8787,3098,41914,14777,20759,14777,741,854,368
Hyper Market,Chain1,Confectionery,Tin Box Fudge(450g),North,2019,5,3.65,13938,50874,26064,10507,3431,38351,12523,13541,12523,300,637,421
Hyper Market,Chain1,Confectionery,Tin Box Fudge(450g),North,2019,6,2.82,16473,46454,17132,13510,2963,38098,8356,8776,8356,953,539,672
Hyper Market,Chain1,Confectionery,Tin Box Fudge(450g),North,2019,7,4.8,11960,57408,36119,8890,3070,42672,14736,21383,14736,345,537,909
Hyper Market,Chain1,Confectionery,Tin Box Fudge(450g),North,2019,8,3.27,18258,59704,27204,13752,4506,44969,14735,12470,14734,751,880,697
Hyper Market,Chain1,Confectionery,Tin Box Fudge(450g),North,2019,9,5.1,10759,54871,35720,9108,1651,46451,8420,27300,8420,897,105,905
Hyper Market,Chain1,Confectionery,Tin Box Fudge(450g),North,2019,10,3.52,19708,69372,34292,14065,5643,49509,19863,14429,19863,228,271,618
Hyper Market,Chain1,Confectionery,Delight Bar(40g),South,2018,1,1.29,32038,41329,21145,26403,5635,34060,7269,13876,7269,658,102,517
Hyper Market,Chain1,Confectionery,Delight Bar(40g),South,2018,2,1.06,32449,34396,13953,25908,6541,27462,6934,7019,6934,375,504,517
Hyper Market,Chain1,Confectionery,Delight Bar(40g),South,2018,3,1.85,30686,56769,37437,22524,8162,41669,15100,22337,15100,305,630,837
Hyper Market,Chain1,Confectionery,Delight Bar(40g),South,2018,4,1.23,27251,33519,16351,19765,7486,24311,9208,7143,9208,865,191,360
Hyper Market,Chain1,Confectionery,Delight Bar(40g),South,2018,5,1.16,32994,38273,17487,24308,8686,28197,10076,7411,10076,541,403,729
Hyper Market,Chain1,Confectionery,Delight Bar(40g),South,2018,6,1.77,29135,51569,33214,20638,8497,36529,15040,18174,15040,691,917,539
Hyper Market,Chain1,Confectionery,Delight Bar(40g),South,2018,7,1.54,28371,43691,25818,22418,5953,34524,9167,16650,9168,205,565,801
Hyper Market,Chain1,Confectionery,Delight Bar(40g),South,2018,8,1.41,31817,44862,24817,25808,6009,36389,8473,16344,8473,239,457,535
Hyper Market,Chain1,Confectionery,Delight Bar(40g),South,2018,9,1.68,24256,40750,25469,21342,2914,35855,4895,20574,4895,578,748,897
Hyper Market,Chain1,Confectionery,Delight Bar(40g),South,2018,10,1.48,23870,35328,20290,18755,5115,27757,7571,12719,7571,563,822,333
Hyper Market,Chain1,Confectionery,Delight Bar(40g),South,2018,11,1.14,32732,37314,16693,23259,9473,26515,10799,5894,10799,906,597,655
Hyper Market,Chain1,Confectionery,Delight Bar(40g),South,2018,12,1.86,23916,44484,29417,18484,5432,34380,10104,19313,10104,664,613,605
Hyper Market,Chain1,Confectionery,Delight Bar(40g),South,2019,1,1.48,33286,49263,28293,29388,3898,43494,5769,22524,5769,474,105,417
Hyper Market,Chain1,Confectionery,Delight Bar(40g),South,2019,2,1,39511,39511,14619,29226,10285,29226,10285,4334,10285,753,622,954
Hyper Market,Chain1,Confectionery,Delight Bar(40g),South,2019,3,1.62,25448,41226,25194,22306,3142,36136,5090,20104,5090,989,186,655
Hyper Market,Chain1,Confectionery,Delight Bar(40g),South,2019,4,1.73,25969,44926,28566,21851,4118,37802,7124,21442,7124,509,488,520
Hyper Market,Chain1,Confectionery,Delight Bar(40g),South,2019,5,1.31,33006,43238,22444,27380,5626,35868,7370,15074,7370,693,177,641
Hyper Market,Chain1,Confectionery,Delight Bar(40g),South,2019,6,1,30530,30530,11296,27158,3372,27158,3372,7924,3372,781,493,720
Hyper Market,Chain1,Confectionery,Delight Bar(40g),South,2019,7,1.74,26724,46500,29664,19190,7534,33391,13109,16555,13109,420,720,434
Hyper Market,Chain1,Confectionery,Delight Bar(40g),South,2019,8,1.19,29457,35054,16496,25387,4070,30211,4843,11653,4843,753,663,133
Hyper Market,Chain1,Confectionery,Delight Bar(40g),South,2019,9,1.85,29426,54438,35900,25841,3585,47806,6632,29268,6632,963,780,175
Hyper Market,Chain1,Confectionery,Delight Bar(40g),South,2019,10,1.26,28546,35968,17984,22247,6299,28031,7937,10047,7937,303,182,192
Hyper Market,Chain1,Confectionery,Trio Bar(100g),South,2018,1,2.48,58066,144004,73744,49121,8945,121820,22184,51560,22184,346,615,521
Hyper Market,Chain1,Confectionery,Trio Bar(100g),South,2018,2,2.03,58888,119543,48288,45538,13350,92442,27101,21188,27100,309,645,938
Hyper Market,Chain1,Confectionery,Trio Bar(100g),South,2018,3,3.45,83417,287789,186854,66490,16927,229391,58398,128456,58398,788,885,201
Hyper Market,Chain1,Confectionery,Trio Bar(100g),South,2018,4,2.38,44489,105884,52052,37664,6825,89640,16244,35808,16244,147,742,473
Hyper Market,Chain1,Confectionery,Trio Bar(100g),South,2018,5,2.27,47475,107768,50324,38947,8528,88410,19358,30965,19359,441,460,762
Hyper Market,Chain1,Confectionery,Trio Bar(100g),South,2018,6,3.33,63814,212501,135286,49621,14193,165238,47263,88023,47263,655,602,776
Hyper Market,Chain1,Confectionery,Trio Bar(100g),South,2018,7,2.9,61304,177782,103604,51131,10173,148280,29502,74102,29502,378,227,881
Hyper Market,Chain1,Confectionery,Trio Bar(100g),South,2018,8,2.67,64359,171839,93964,57207,7152,152743,19096,74869,19095,385,733,974
Hyper Market,Chain1,Confectionery,Trio Bar(100g),South,2018,9,3.16,53582,169319,104485,38881,14701,122864,46455,58030,46455,534,725,326
Hyper Market,Chain1,Confectionery,Trio Bar(100g),South,2018,10,2.81,47866,134503,76586,42600,5266,119706,14797,61788,14798,301,303,484
Hyper Market,Chain1,Confectionery,Trio Bar(100g),South,2018,11,2.2,56717,124777,56150,47553,9164,104617,20160,35989,20161,827,446,962
Hyper Market,Chain1,Confectionery,Trio Bar(100g),South,2018,12,3.48,58638,204060,133108,45305,13333,157661,46399,86709,46399,494,604,572
Hyper Market,Chain1,Confectionery,Trio Bar(100g),South,2019,1,2.78,76119,211611,119507,62379,13740,173414,38197,81310,38197,185,225,850
Hyper Market,Chain1,Confectionery,Trio Bar(100g),South,2019,2,1.95,58519,114112,43304,50704,7815,98873,15239,28065,15239,541,205,533
Hyper Market,Chain1,Confectionery,Trio Bar(100g),South,2019,3,3.1,48397,150031,91470,41363,7034,128225,21806,69665,21805,150,675,577
Hyper Market,Chain1,Confectionery,Trio Bar(100g),South,2019,4,3.25,57823,187925,117959,42042,15781,136637,51288,66671,51288,766,588,203
Hyper Market,Chain1,Confectionery,Trio Bar(100g),South,2019,5,2.46,76554,188323,95693,63217,13337,155514,32809,62884,32809,224,371,320
Hyper Market,Chain1,Confectionery,Trio Bar(100g),South,2019,6,1.91,60315,115202,42221,48293,12022,92240,22962,19259,22962,298,149,324
Hyper Market,Chain1,Confectionery,Trio Bar(100g),South,2019,7,3.24,74299,240729,150827,52482,21817,170042,70687,80140,70687,217,915,428
Hyper Market,Chain1,Confectionery,Trio Bar(100g),South,2019,8,2.27,58394,132554,61898,50675,7719,115032,17522,44375,17523,114,411,920
Hyper Market,Chain1,Confectionery,Trio Bar(100g),South,2019,9,3.45,74468,256915,166808,55043,19425,189898,67017,99792,67016,845,900,832
Hyper Market,Chain1,Confectionery,Trio Bar(100g),South,2019,10,2.43,50263,122139,61321,39445,10818,95851,26288,35033,26288,626,586,696
Hyper Market,Chain1,Confectionery,Tin Box Fudge(450g),South,2018,1,3.58,47785,171070,86013,37701,10084,134970,36100,49913,36100,489,927,959
Hyper Market,Chain1,Confectionery,Tin Box Fudge(450g),South,2018,2,2.97,35055,104113,41715,31308,3747,92985,11128,30587,11128,264,574,846
Hyper Market,Chain1,Confectionery,Tin Box Fudge(450g),South,2018,3,5.08,42384,215311,139867,30122,12262,153020,62291,77576,62291,255,203,732
Hyper Market,Chain1,Confectionery,Tin Box Fudge(450g),South,2018,4,3.45,33240,114678,55511,24179,9061,83418,31260,24251,31260,283,915,705
Hyper Market,Chain1,Confectionery,Tin Box Fudge(450g),South,2018,5,3.19,47796,152469,67392,37779,10017,120515,31954,35438,31954,789,794,119
Hyper Market,Chain1,Confectionery,Tin Box Fudge(450g),South,2018,6,4.8,54611,262133,164925,43539,11072,208987,53146,111779,53146,653,883,363
Hyper Market,Chain1,Confectionery,Tin Box Fudge(450g),South,2018,7,4.26,34880,148589,86502,30808,4072,131242,17347,69156,17346,162,349,580
Hyper Market,Chain1,Confectionery,Tin Box Fudge(450g),South,2018,8,3.93,32839,129057,70604,23746,9093,93322,35735,34869,35735,218,738,939
Hyper Market,Chain1,Confectionery,Tin Box Fudge(450g),South,2018,9,4.6,39913,183600,112555,30262,9651,139205,44395,68160,44395,722,750,485
Hyper Market,Chain1,Confectionery,Tin Box Fudge(450g),South,2018,10,4.03,43865,176776,98696,32652,11213,131588,45188,53508,45188,328,491,973
Hyper Market,Chain1,Confectionery,Tin Box Fudge(450g),South,2018,11,3.16,51445,162566,70994,38318,13127,121085,41481,29513,41481,519,239,642
Hyper Market,Chain1,Confectionery,Tin Box Fudge(450g),South,2018,12,5.07,35871,181866,118016,31086,4785,157606,24260,93756,24260,200,422,824
Hyper Market,Chain1,Confectionery,Tin Box Fudge(450g),South,2019,1,4.05,48680,197154,110504,40484,8196,163960,33194,77310,33194,882,162,987
Hyper Market,Chain1,Confectionery,Tin Box Fudge(450g),South,2019,2,2.76,54031,149126,52950,40332,13699,111316,37810,15141,37809,179,542,856
Hyper Market,Chain1,Confectionery,Tin Box Fudge(450g),South,2019,3,4.42,44550,196911,117612,38738,5812,171222,25689,91923,25689,603,363,436
Hyper Market,Chain1,Confectionery,Tin Box Fudge(450g),South,2019,4,4.77,33865,161536,101256,23893,9972,113970,47566,53690,47566,937,478,373
Hyper Market,Chain1,Confectionery,Tin Box Fudge(450g),South,2019,5,3.65,30305,110613,56670,26007,4298,94926,15687,40983,15687,636,440,188
Hyper Market,Chain1,Confectionery,Tin Box Fudge(450g),South,2019,6,2.82,29885,84276,31080,26585,3300,74970,9306,21775,9305,184,169,467
Hyper Market,Chain1,Confectionery,Tin Box Fudge(450g),South,2019,7,4.8,31279,150139,94463,25458,5821,122198,27941,66521,27942,538,808,565
Hyper Market,Chain1,Confectionery,Tin Box Fudge(450g),South,2019,8,3.27,50592,165436,75382,41787,8805,136643,28793,46589,28793,297,632,160
Hyper Market,Chain1,Confectionery,Tin Box Fudge(450g),South,2019,9,5.1,34743,177189,115347,28225,6518,143948,33241,82105,33242,352,969,741
Hyper Market,Chain1,Confectionery,Tin Box Fudge(450g),South,2019,10,3.52,40247,141669,70030,30256,9991,106501,35168,34861,35169,309,432,504
Hyper Market,Chain1,Confectionery,Delight Bar(40g),East,2018,1,1.29,46041,59393,29927,38593,7448,49785,9608,20319,9608,553,689,245
Hyper Market,Chain1,Confectionery,Delight Bar(40g),East,2018,2,1.06,52203,55335,21925,39871,12332,42263,13072,8853,13072,594,812,952
Hyper Market,Chain1,Confectionery,Delight Bar(40g),East,2018,3,1.85,31341,57981,37923,26220,5121,48507,9474,28449,9474,140,944,614
Hyper Market,Chain1,Confectionery,Delight Bar(40g),East,2018,4,1.23,44313,54505,26145,33525,10788,41236,13269,12876,13269,640,654,184
Hyper Market,Chain1,Confectionery,Delight Bar(40g),East,2018,5,1.16,50218,58253,26113,41228,8990,47824,10429,15684,10429,171,449,651
Hyper Market,Chain1,Confectionery,Delight Bar(40g),East,2018,6,1.77,31368,55521,35446,23090,8278,40869,14652,20793,14653,241,420,372
Hyper Market,Chain1,Confectionery,Delight Bar(40g),East,2018,7,1.54,30521,47002,27469,25069,5452,38606,8396,19073,8396,284,688,280
Hyper Market,Chain1,Confectionery,Delight Bar(40g),East,2018,8,1.41,39601,55837,30493,27950,11651,39410,16427,14065,16428,391,852,656
Hyper Market,Chain1,Confectionery,Delight Bar(40g),East,2018,9,1.68,35621,59843,37046,29763,5858,50002,9841,27205,9841,927,805,315
Hyper Market,Chain1,Confectionery,Delight Bar(40g),East,2018,10,1.48,38513,56999,32351,30290,8223,44829,12170,20181,12170,236,810,656
Hyper Market,Chain1,Confectionery,Delight Bar(40g),East,2018,11,1.14,45459,51823,22730,33890,11569,38635,13188,9541,13189,833,945,661
Hyper Market,Chain1,Confectionery,Delight Bar(40g),East,2018,12,1.86,37178,69151,45357,31058,6120,57768,11383,33974,11383,358,993,788
Hyper Market,Chain1,Confectionery,Delight Bar(40g),East,2019,1,1.48,30511,45156,25629,23116,7395,34212,10944,14685,10944,421,674,786
Hyper Market,Chain1,Confectionery,Delight Bar(40g),East,2019,2,1,48872,48872,17594,40920,7952,40920,7952,9642,7952,588,152,552
Hyper Market,Chain1,Confectionery,Delight Bar(40g),East,2019,3,1.62,48025,77801,47065,42900,5125,69498,8303,38762,8303,121,930,344
Hyper Market,Chain1,Confectionery,Delight Bar(40g),East,2019,4,1.73,40788,70563,44459,34182,6606,59135,11428,33031,11428,365,902,966
Hyper Market,Chain1,Confectionery,Delight Bar(40g),East,2019,5,1.31,40654,53257,27238,31399,9255,41133,12124,15114,12124,181,470,678
Hyper Market,Chain1,Confectionery,Delight Bar(40g),East,2019,6,1,44383,44383,15978,37435,6948,37435,6948,9030,6948,944,891,727
Hyper Market,Chain1,Confectionery,Delight Bar(40g),East,2019,7,1.74,33207,57780,36528,25520,7687,44405,13375,23153,13375,493,812,136
Hyper Market,Chain1,Confectionery,Delight Bar(40g),East,2019,8,1.19,36277,43170,19952,28887,7390,34376,8794,11159,8793,786,536,337
Hyper Market,Chain1,Confectionery,Delight Bar(40g),East,2019,9,1.85,40653,75208,49190,30484,10169,56395,18813,30377,18813,763,497,822
Hyper Market,Chain1,Confectionery,Delight Bar(40g),East,2019,10,1.26,49098,61863,30441,36387,12711,45848,16015,14425,16016,320,982,247
Hyper Market,Chain1,Confectionery,Trio Bar(100g),East,2018,1,2.48,54237,134508,68339,44677,9560,110799,23709,44630,23709,303,428,981
Hyper Market,Chain1,Confectionery,Trio Bar(100g),East,2018,2,2.03,62088,126039,50291,54028,8060,109677,16362,33930,16361,568,846,420
Hyper Market,Chain1,Confectionery,Trio Bar(100g),East,2018,3,3.45,61096,210781,136244,46294,14802,159714,51067,85177,51067,249,830,467
Hyper Market,Chain1,Confectionery,Trio Bar(100g),East,2018,4,2.38,48307,114971,56036,37912,10395,90231,24740,31296,24740,306,823,870
Hyper Market,Chain1,Confectionery,Trio Bar(100g),East,2018,5,2.27,45624,103566,47905,37559,8065,85259,18307,29598,18307,267,806,622
Hyper Market,Chain1,Confectionery,Trio Bar(100g),East,2018,6,3.33,43052,143363,90840,37998,5054,126533,16830,74010,16830,851,457,543
Hyper Market,Chain1,Confectionery,Trio Bar(100g),East,2018,7,2.9,41574,120565,69844,36562,5012,106030,14535,55310,14534,180,518,906
Hyper Market,Chain1,Confectionery,Trio Bar(100g),East,2018,8,2.67,51595,137759,74813,39587,12008,105697,32062,42751,32062,342,654,342
Hyper Market,Chain1,Confectionery,Trio Bar(100g),East,2018,9,3.16,49703,157061,96424,37730,11973,119227,37834,58589,37835,521,275,213
Hyper Market,Chain1,Confectionery,Trio Bar(100g),East,2018,10,2.81,50096,140770,79653,42417,7679,119192,21578,58075,21578,313,978,715
Hyper Market,Chain1,Confectionery,Trio Bar(100g),East,2018,11,2.2,52429,115344,51380,42338,10091,93144,22200,29181,22199,881,686,110
Hyper Market,Chain1,Confectionery,Trio Bar(100g),East,2018,12,3.48,64045,222877,144742,45807,18238,159408,63469,81273,63469,241,539,417
Hyper Market,Chain1,Confectionery,Trio Bar(100g),East,2019,1,2.78,46913,130418,73184,34646,12267,96316,34102,39082,34102,286,760,163
Hyper Market,Chain1,Confectionery,Trio Bar(100g),East,2019,2,1.95,53094,103533,38759,41347,11747,80627,22906,15852,22907,321,875,986
Hyper Market,Chain1,Confectionery,Trio Bar(100g),East,2019,3,3.1,58418,181096,109826,45555,12863,141221,39875,69951,39875,112,379,128
Hyper Market,Chain1,Confectionery,Trio Bar(100g),East,2019,4,3.25,57215,185949,116146,43212,14003,140439,45510,70637,45509,344,222,903
Hyper Market,Chain1,Confectionery,Trio Bar(100g),East,2019,5,2.46,63635,156542,78907,48452,15183,119192,37350,41557,37350,781,731,932
Hyper Market,Chain1,Confectionery,Trio Bar(100g),East,2019,6,1.91,56834,108553,39215,47754,9080,91210,17343,21873,17342,632,610,314
Hyper Market,Chain1,Confectionery,Trio Bar(100g),East,2019,7,3.24,65244,211391,131793,47501,17743,153903,57488,74305,57488,404,528,931
Hyper Market,Chain1,Confectionery,Trio Bar(100g),East,2019,8,2.27,46545,105657,48872,34592,11953,78524,27133,21739,27133,995,154,953
Hyper Market,Chain1,Confectionery,Trio Bar(100g),East,2019,9,3.45,73382,253168,163642,59215,14167,204292,48876,114766,48876,783,308,652
Hyper Market,Chain1,Confectionery,Trio Bar(100g),East,2019,10,2.43,57276,139181,69304,43140,14136,104830,34351,34953,34351,121,799,194
Hyper Market,Chain1,Confectionery,Tin Box Fudge(450g),East,2018,1,3.58,42252,151262,75631,34108,8144,122107,29155,46476,29155,319,374,678
Hyper Market,Chain1,Confectionery,Tin Box Fudge(450g),East,2018,2,2.97,41145,122201,48551,30904,10241,91785,30416,18135,30416,722,982,489
Hyper Market,Chain1,Confectionery,Tin Box Fudge(450g),East,2018,3,5.08,31811,161600,104658,23796,8015,120884,40716,63942,40716,783,386,791
Hyper Market,Chain1,Confectionery,Tin Box Fudge(450g),East,2018,4,3.45,34468,118915,57217,25234,9234,87057,31858,25359,31858,371,768,752
Hyper Market,Chain1,Confectionery,Tin Box Fudge(450g),East,2018,5,3.19,41943,133798,58720,32490,9453,103643,30155,28565,30155,187,831,363
Hyper Market,Chain1,Confectionery,Tin Box Fudge(450g),East,2018,6,4.8,33685,161688,101392,27124,6561,130195,31493,69899,31493,194,110,505
Hyper Market,Chain1,Confectionery,Tin Box Fudge(450g),East,2018,7,4.26,24346,103714,60135,17334,7012,73843,29871,30264,29871,628,586,939
Hyper Market,Chain1,Confectionery,Tin Box Fudge(450g),East,2018,8,3.93,29072,114253,62214,25480,3592,100136,14117,48097,14117,515,878,882
Hyper Market,Chain1,Confectionery,Tin Box Fudge(450g),East,2018,9,4.6,35445,163047,99600,27893,7552,128308,34739,64861,34739,256,928,423
Hyper Market,Chain1,Confectionery,Tin Box Fudge(450g),East,2018,10,4.03,42620,171759,95469,32776,9844,132087,39672,55797,39672,566,614,514
Hyper Market,Chain1,Confectionery,Tin Box Fudge(450g),East,2018,11,3.16,41809,132116,57278,33728,8081,106580,25536,31742,25536,309,393,225
Hyper Market,Chain1,Confectionery,Tin Box Fudge(450g),East,2018,12,5.07,42496,215455,139387,36874,5622,186951,28504,110883,28504,955,696,909
Hyper Market,Chain1,Confectionery,Tin Box Fudge(450g),East,2019,1,4.05,33347,135055,75364,29514,3833,119532,15523,59841,15523,221,910,780
Hyper Market,Chain1,Confectionery,Tin Box Fudge(450g),East,2019,2,2.76,48680,134357,47220,37238,11442,102777,31580,15640,31580,559,521,893
Hyper Market,Chain1,Confectionery,Tin Box Fudge(450g),East,2019,3,4.42,53071,234574,139577,44080,8991,194834,39740,99837,39740,474,193,853
Hyper Market,Chain1,Confectionery,Tin Box Fudge(450g),East,2019,4,4.77,36238,172855,107989,25875,10363,123424,49431,58558,49431,753,868,461
Hyper Market,Chain1,Confectionery,Tin Box Fudge(450g),East,2019,5,3.65,26520,96798,49327,19469,7051,71062,25736,23591,25736,557,835,884
Hyper Market,Chain1,Confectionery,Tin Box Fudge(450g),East,2019,6,2.82,27497,77542,28322,22775,4722,64226,13316,15006,13316,705,238,288
Hyper Market,Chain1,Confectionery,Tin Box Fudge(450g),East,2019,7,4.8,30489,146347,91772,26993,3496,129566,16781,74991,16781,629,260,667
Hyper Market,Chain1,Confectionery,Tin Box Fudge(450g),East,2019,8,3.27,36808,120362,54476,28972,7836,94738,25624,28852,25624,918,787,848
Hyper Market,Chain1,Confectionery,Tin Box Fudge(450g),East,2019,9,5.1,35469,180892,117402,31514,3955,160721,20171,97231,20171,218,144,432
Hyper Market,Chain1,Confectionery,Tin Box Fudge(450g),East,2019,10,3.52,41375,145640,71579,32586,8789,114703,30937,40642,30937,188,637,344
